111111111111111111
1x0010000000000001
111011101111111101
101010000100000001
101011010101111111
101000010100001001
100011110101111101
101110010100000001
100000000101101111
101101111100100001
101001000000101001
101101111111101001
101000000000001001
101011110100101001
101000010111111001
111011110100000001
101000000101111111
101011110101010101
1000000101000000#1
111111111111111111
